11111
1EC11
11111
11CP1
11111
