11111111111111
10001C1E000001
100P000C100001
10111000111111
1C111C10111111
10000000000001
11111111111111