11111111
10001011
100P1111
1011E111
1011C111
1C000111
11111111