111111111111111111111111111
1000101C0000100000000000001
1000101C0000100000000000001
1000101C0000100000000000001
1000101C0000100000000000001
100P11111100111100000000001
1000101C0000101111C11111101
1000101C0000100000000000001
1000101C0000100000000000001
1011EC000000111111100000001
1011C11C0000CC1111111111101
1C000000C0000000000000000C1
111111111111111111111111111