111111111
10011C1E1
100P000C1
101110001
1C111C101
111111111
