111111
100111
100P01
101111
1C01E1
111111
