11111111111111
10001C10000001
100P000C000001
101110000E0111
1C111C10001111
10000000000001
11111111111111