1111111111111
10010000000C1
1000011111011
1P0011E000001
1000000000001
1000111110001
10C00000C0001
1111111111111
